R   640   400

NO ./textures/ironwall128.xpm

SO ./textures/brickwall128.xpm

WE ./textures/pipewall128.xpm

EA ./textures/metalwall128.xpm

S ./textures/pig128.xpm

F 178,167,87

C 89,78,93

11111111111111111111
1mm0000g000k0000h0m1
100000010m0000001001
1001000g00000000g0n1
10010c01111100001111
10011111e00l0000d001
10000001111100001001
10000001000000001001
1000000d000001101001
1m00s00100000gp010N1
11111111111111111111
