R   640   400

NO ./textures/ironwall128.xpm

SO ./textures/brickwall128.xpm

WE ./textures/pipewall128.xpm

EA ./textures/metalwall128.xpm

S ./textures/pig128.xpm

F 178,167,87

C 89,78,93

11111111111111111111
10000001000k0000h001
100000010m0000001001
100100010000000010n1
10010c01111100001111
10011111e00l00000001
100000011e1100001001
10000001000000001001
10000000000001101001
1000s00d000001p010N1
11111111111111111111
