R   640   400

NO ./textures/ironwall128.xpm

SO ./textures/brickwall128.xpm

WE ./textures/pipewall128.xpm

EA ./textures/metalwall128.xpm

S ./textures/pig128.xpm

F 178,167,87

C 89,78,93

        1111111111111111111111111
        1000000000000000000000001
        100000000011000000000m001
        1011000001110000000m00001
111111111000000001110000111111111
1001000000000100000010001
100000000000000000000000111111111
111111111011000001110000000000001
100000000011000001110111111111111
1111011111111101110000001mm01
11110111111111011101010010001
11000000110101011100000000N01
10000000000000001101111110001
10000000000000001101010010001
1111111111010101111101111000111
11110111 1110101 101111010001
11111111 1111111 111111111111
