R 800 600

NO ./textures/north_texture.xpm

SO ./textures/south_texture.xpm

WE ./textures/west_texture.xpm

EA ./textures/east_texture.xpm

S ./textures/boss.xpm

F 255,255,255

C 0,0,0

        1111111111111111111111111
        1000000000000000000000001
        1000000000110000000022001
        1011000001110000002200001
111111111000000001110000111111111
1001000000000100000010001
100000000000000000000000111111111
111111111011000001110000000000001
100000000011000001110111111111111
11110111111111011100000010001
11110111111111011101010010001
11000000110101011100000000N01
10000000000000001101111110001
10000000000000001101010010001
1111111111010101111101111000111
11110111 1110101 101111010001
11111111 1111111 111111111111
