R 640 400

NO ./textures/north_texture

SO ./textures/south_texture

WE ./textures/west_texture

EA ./textures/east_texture

S ./textures/sprite_texture

F 0,255,255

C 0,0,0

        1111111111111111111111111
        1000000000000000000000001
        1000000000110000000000001
        1011010001110000002000001
1111111110001 1001110000111111111
1001000000000100000000001
100000000000000000000000111111111
111111111011000001110000000000001
100000000011000001110111111111111
11110111111111011100000010001
11110111111111011101010010001
11000000110101011100000000N01
10000000000000001101111110001
10000000000000001101010010001
1111111111010101111101111000111
11110111 1110101 101111010001
11111111 1111111 111111111111
