R 640 400

NO ./textures/north_texture.xpm

SO ./textures/south_texture.xpm

WE ./textures/west_texture.xpm

EA ./textures/east_texture.xpm

S ./textures/sprite_texture.xpm

F 255,255,255

C 0,0,0

 1111
10N01
100011111
1000000001
1001100001
1000000001
1111111111
