R 640 400

NO ./textures/north_texture

SO ./textures/south_texture

WE ./textures/west_texture

EA ./textures/east_texture

S ./textures/sprite_texture

F 255,255,255

C 0,0,0

 1111
10N01
1111
